
przewałowych -> przewozowych
prawnomaterialną -> prawnomaterialnej
retroaktywną -> retroaktywne
łecznych -> licznych
współosadzonym -> współosadzonych
jątkowej -> majątkowej
energ -> energii
tollendi -> solvendi
błuś -> błąd
przekroczonie -> przekroczenie
nowopowstałego -> nowopowstałej
gdańca -> gdańska
ściomiesięcznego -> comiesięcznego
administrative -> administratif
ubezskutecznieniu -> ubezskutecznienie
interoperatywności -> interoperacyjności
ruzikowski -> ruśkowski
gebbelsa -> goebbelsa
zmaliński -> zieliński
intertemporalna -> intertemporalne
skazań -> wskazał
legem -> celem
przywidzianej -> przewidziane
głownego -> głównego
reformatoryjny -> reformatoryjnym
konkludentnym -> konkludentne
szczególmymi -> szczególnym
espresio -> expresis
kauzą -> karą
konkubenckim -> konsumenckim
